##########
#A   #   #
#  # # ### 
# ##     #
#  ####  #
#    #   #
#    #  B#
##########
