                                                          ####            
                                                          #  #            
               ############################################  #            
               #            #    #           #    #          #            
               #            #    #           #    #          #            
               #            #    #           #    #          #            
               #            #    #           #    #     ###  #            
               #            #    #           #          # #  #            
               ### ## ######## #### ######## ######     # #  #            
               #                                        # #  #            
               #                                        # #  #            
               #                                        # #  #            
               ### ##  ####### ###  ############# #     # #  #            
               #    #            #           #    #     # #  #            
               #    #            #           #    #     ###  #            
               #    #            #           #    #     #A   #            
               #    #            #           #    #     ##################
               #    #            #           #    #          #           #
               #    #            #           #    #          #           #
               #    #            #           #    #          #           #
               #    #            #           #    #          #           #
               #########################################     # ###########
                                                       #                 #
                                                       #                 #
                                                       #     #           #
                                                       #     #           #
                                                       #     #           #
                                                       #     #           #
                                                       #     #           #
                                                       #     #           #
                                                       #     #           #
                                                       #     #           #
                                                       #     #############
                                                       #     #           #
                                                       #     #           #
                                                       #     #           #
                                                       #                 #
                                                       #                 #
                                                       #     #           #
                                                       #     #           #
                                                       #     #           #
                                                       #     #############
                                                       #     #       #   #
                                                       #     #       #   #
                                                       #     #       #   #
                                                       #     #       #   #
                                                       #             #   #
                                                       #             #   #
                                                       #     #       #   #
                                                       #     #           #
                                                       #     #############
                                                       #     #           #
                                                       #                 #
                                                       #                 #
##################                                     #     #############
#           #    #                                     #     #       #   #
#           #    #                                     #     #       #   #
#           #    #                                     #     #       #   #
#           #    #                                     #     #       #   #
#           #    #                                     #     # ######## ##
#           #### #######################################     #           #
#           #        #   #   #            #    #   #   #     #           #
#           #        #   #   #            #    #   #   #     #           #
#           #        #   #   #   #######  #    #   #   #                 #
#########  ##        #   #   #   #     #  #    #   #   #     # ###########
#       #   #        #   #   #   #     #  #    #   #   #     #           #
#       #   #        ### # ###   #     #  #### ### #   #     #           #
#       #   #        #       #   #######  #  #               #           #
#       #   ### ########### ##         ####  ##### #####     #           #
#       #   #                                                #           #
#                                                                        #
#       B                                                                #
#                                                            #           #
#       #   ####  ##########  ##  ######   ## #######  #######           #
#       #   #                 #        #   #                 #           #
#       #   #                 #        #   #   #             #           #
#       #   #                 #        #   #   #             #           #
#       #   #                 #        #   #   #             #           #
#########  ##                 #        #   #   #             #           #
#           #                 #        #   #   #             #           #
#           #                 #        #   # ###             #           #
#           #                 #        #   #   #             #           #
#           #                 #        #   #   #             #           #
#           ##################################################           #
#           #                                                #           #
#           #                                                #           #
#           #                                                #           #
#           #                                                #           #
#############                                                #############
