 , , , , , , , , , , , , , , , , , , , , , , , , , , , , , , , , , , , , , , , , , , , , , , , , , , , , , , , , , , , , , , , , , , , , ,#, , ,#, , , , , , , , , , , , 
 , , , , , , , , , , , , , , , , , , , , , , , ,#,#, , ,#,#,#,#,#,#,#,#,#,#,#,#,#,#,#,#,#,#,#,#,#,#,#,#,#,#,#,#,#,#,#,#,#,#,#, , ,#,#,#,#,#, , ,#, , , , , , , , , , , , 
 , , , , , , , , , , , , , , , , , , , , , , , ,#, , , , ,#, , , ,#, , , , , , , , ,#, , , , ,#, , , , , , , , ,#, , , , ,#, , , , ,#, , , , , ,#, , , , , , , , , , , , 
 , , , , , , , , , , , , , , , , , , , , , , , ,#, , , , ,#, , , ,#, , , , , , , , ,#, , , , ,#, , , , , , , , ,#, , , , ,#, , , , ,#, , , , , ,#, , , , , , , , , , , , 
 , , , , , , , , , , , , , , , , , , , , , , , ,#, ,STORAGE F1, , ,#, ,MALE CR 1, ,#, , , ,RH-119, , , , ,#, ,RH-117, , ,#, , , ,RH-115, , , , ,#, ,FEMALE CR 1, , ,#, , , , ,#,#,#,#, , ,#, , , , , , , , , , , , 
 , , , , , , , , , , , , , , , , , , , , , , , ,#, , , , ,#, , , ,#, , , , , , , , ,#, , , , ,#, , , ,RH-113, , , , ,#, , , , ,#, , , , , , , ,#, , ,#, , , , , , , , , , , , 
 , , , , , , , , , , , , , , , , , , , , , , , ,#, , , , ,#, , , ,#, , , , , , , , ,#, , , , ,#, , , ,, , , , ,#, , , , ,#, , , , , , , ,#, , ,#, , , , , , , , , , , , 
 , , , , , , , , , , , , , , , , , , , , , , , ,#,#,#, ,#,#,#,#, ,#,#, , ,#,#,#,#,#,#,#, , ,#,#,#,#, ,#,#, ,#,#,#,#, ,#,#,#, , , , , , , , , , ,#, , , , , , , , , , , , 
 , , , , , , , , , , , , , , , , , , , , , , , ,#, , , , , , , , , , , , , , , , , , , , , , , , , , , , , , , , , , , , , , , , , , , , ,#, , ,#, , , , , , , , , , , , 
 , , , , , , , , , , , , , , , , , , , , , , , ,#, , , , , , , , , , , , , , , , , , , , , , , , , , , , , , , , , , , , , , , , , , , , ,#, , ,#, , , , , , , , , , , , 
 , , , , , , , , , , , , , , , , , , , , , , , ,#, , , , , , , , , , , , , , , , , , , , , , , , , , , , , , , , , , , , , , , , , , , , ,#, , ,#, , , , , , , , , , , , 
 , , , , , , , , , , , , , , , , , , , , , , , ,#,#, , ,#,#, , ,#,#,#,#,#,#,#,#, , ,#,#,#,#,#,#,#,#,#,#,#, , ,#,#,#,#,#,#,#, , , , , , , ,#, , ,#, , , , , , , , , , , , 
 , , , , , , , , , , , , , , , , , , , , , , , ,#, , , , ,#, , , , , , , , , , , , ,#, , , , ,#, , , , , , , , , , , , , ,#, , , , , , , ,#, , ,#, , , , , , , , , , , , 
 , , , , , , , , , , , , , , , , , , , , , , , ,#, , , , ,#, , , , , , , , , , , , ,#, , , , ,#, , , , , , , , , , , , , ,#, , , , , ,#,#,#, , ,#, , , , , , , , , , , , 
 , , , , , , , , , , , , , , , , , , , , , , , ,#, , , , ,#, , , , , , , , , , , , ,#, , , , ,#, , , , , , , , , , , , , ,#, , , , , , , , , , ,#, , , , , , , , , , , , 
 , , , , , , , , , , , , , , , , , , , , , , , ,#, ,STORAGE 1 F1, , ,#, , , , ,RH-116, , , , , , , ,#, ,RH-114, , ,#, , , , , ,RH-112, , , , , , , ,#, , , , , , , , , , ,#, , , , , , , , , , , , 
 , , , , , , , , , , , , , , , , , , , , , , , ,#, , , , ,#, , , , , , , , , , , , ,#, , , , ,#, , , , , , , , , , , , , ,#, , , , ,#,#,#,#,#,#,#,#,#,#,#,#,#,#,#,#,#,#,#
 , , , , , , , , , , , , , , , , , , , , , , , ,#, , , , ,#, , , , , , , , , , , , ,#, , , , ,#, , , , , , , , , , , , , ,#, , , , , , , , , , , , , , , , , , , , , , ,#
 , , , , , , , , , , , , , , , , , , , , , , , ,#, , , , ,#, , , , , , , , , , , , ,#, , , , ,#, , , , , , , , , , , , , ,#, , , , ,#, , , , , , , , , , , , , , , , , ,#
 , , , , , , , , , , , , , , , , , , , , , , , ,#, , , , ,#, , , , , , , , , , , , ,#, , , , ,#, , , , , , , , , , , , , ,#, , , , ,#, , , , , , , , , , , , , , , , , ,#
 , , , , , , , , , , , , , , , , , , , , , , , ,#,#,#,#,#,#,#,#,#,#,#,#,#,#,#,#,#,#,#,#,#,#,#,#,#,#,#,#,#,#,#,#,#,#,#,#,#,#,#, , , ,#, , , , , , , , , , , , , , , , , ,#
 , , , , , , , , , , , , , , , , , , , , , , , , , , , , , , , , , , , , , , , , , , , , , , , , , , , , , , , , , , , , , ,#, , , ,#, , , , , , , , , , , , , , , , , ,#
 , , , , , , , , , , , , , , , , , , , , , , , , , , , , , , , , , , , , , , , , , , , , , , , , , , , , , , , , , , , , , ,#, , , ,#, , , , , , , , , , , , , , , , , ,#
 , , , , , , , , , , , , , , , , , , , , , , , , , , , , , , , , , , , , , , , , , , , , , , , , , , , , , , , , , , , , , ,#, , , ,#, , , , , , , , , , , , , , , , , ,#
 , , , , , , , , , , , , , , , , , , , , , , , , , , , , , , , , , , , , , , , , , , , , , , , , , , , , , , , , , , , , , , , , , ,#, , , , , , , , , , , , , , , , , ,#
 , , , , , , , , , , , , , , , , , , , , , , , , , , , , , , , , , , , , , , , , , , , , , , , , , , , , , , , , , , , , , , , , , ,#, , , , , , , , , , , , , , , , , ,#
 , , , , , , , , , , , , , , , , , , , , , , , , , , , , , , , , , , , , , , , , , , , , , , , , , , , , , , , , , , , , , , , , , ,#, , , , , , , , , , , , , , , , , ,#
 , , , , , , , , , , , , , , , , , , , , , , , , , , , , , , , , , , , , , , , , , , , , , , , , , , , , , , , , , , , , , , , , , ,#, , , , , , , , , , , , , , , , , ,#
 , , , , , , , , , , , , , , , , , , , , , , , , , , , , , , , , , , , , , , , , , , , , , , , , , , , , , , , , , , , , , , , , , ,#, , , , , , , , , , , , , , , , , ,#
 , , , , , , , , , , , , , , , , , , , , , , , , , , , , , , , , , , , , , , , , , , , , , , , , , , , , , , , , , , , , , , , , , ,#, , , , , , , , , , , , , , , , , ,#
 , , , , , , , , , , , , , , , , , , , , , , , , , , , , , , , , , , , , , , , , , , , , , , , , , , , , , , , , , , , , , , , , , ,#, , , , , , , , , , , , , , , , , ,#
 , , , , , , , , , , , , , , , , , , , , , , , , , , , , , , , , , , , , , , , , , , , , , , , , , , , , , , , , , , , , , , , , , ,#, , , , , , , , , , , , , , , , , ,#
 , , , , , , , , , , , , , , , , , , , , , , , , , , , , , , , , , , , , , , , , , , , , , , , , , , , , , , , , , , , , , , , , , ,#, , , , , , , , , , , , , , , , , ,#
 , , , , , , , , , , , , , , , , , , , , , , , , , , , , , , , , , , , , , , , , , , , , , , , , , , , , , , , , , , , , , , , , , ,#, , , , , , , , , , , , , , , , , ,#
 , , , , , , , , , , , , , , , , , , , , , , , , , , , , , , , , , , , , , , , , , , , , , , , , , , , , , , , , , , , , , , , , , , , , , , , , , , , , , , , , , , , ,#
 , , , , , , , , , , , , , , , , , , , , , , , , , , , , , , , , , , , , , , , , , , , , , , , , , , , , , , , , , , , , , , , , , , , , , , , , , ,LITTLE THEATER, , , , , , , , , ,#
 , , , , , , , , , , , , , , , , , , , , , , , , , , , , , , , , , , , , , , , , , , , , , , , , , , , , , , , , , , , , , , , , , , , , , , , , , , , , , , , , , , , ,#
 , , , , , , , , , , , , , , , , , , , , , , , , , , , , , , , , , , , , , , , , , , , , , , , , , , , , , , , , , , , , , , , , , ,#, , , , , , , , , , , , , , , , , ,#
 , , , , , , , , , , , , , , , , , , , , , , , , , , , , , , , , , , , , , , , , , , , , , , , , , , , , , , , , , , , , , , , , , ,#, , , , , , , , , , , , , , , , , ,#
 , , , , , , , , , , , , , , , , , , , , , , , , , , , , , , , , , , , , , , , , , , , , , , , , , , , , , , , , , , , , , , , , , ,#, , , , , , , , , , , , , , , , , ,#
 , , , , , , , , , , , , , , , , , , , , , , , , , , , , , , , , , , , , , , , , , , , , , , , , , , , , , , , , , , , , , , , , , ,#, , , , , , , , , , , , , , , , , ,#
 , , , , , , , , , , , , , , , , , , , , , , , , , , , , , , , , , , , , , , , , , , , , , , , , , , , , , , , , , , , , , , , , , ,#, , , , , , , , , , , , , , , , , ,#
 , , , , , , , , , , , , , , , , , , , , , , , , , , , , , , , , , , , , , , , , , , , , , , , , , , , , , , , , , , , , , , , , , ,#, , , , , , , , , , , , , , , , , ,#
 , , , , , , , , , , , , , , , , , , , , , , , , , , , , , , , , , , , , , , , , , , , , , , , , , , , , , , , , , , , , , , , , , ,#, , , , , , , , , , , , , , , , , ,#
 , , , , , , , , , , , , , , , , , , , , , , , , , , , , , , , , , , , , , , , , , , , , , , , , , , , , , , , , , , , , , , , , , ,#, , , , , , , , , , , , , , , , , ,#
 , , , , , , , , , , , , , , , , , , , , , , , , , , , , , , , , , , , , , , , , , , , , , , , , , , , , , , , , , , , , , , , , , ,#, , , , , , , , , , , , , , , , , ,#
 , , , , , , , , , , , , , , , , , , , , , , , , , , , , , , , , , , , , , , , , , , , , , , , , , , , , , , , , , , , , , , , , , ,#, , , , , , , , , , , , , , , , , ,#
 , , , , , , , , , , , , , , , , , , , , , , , , , , , , , , , , , , , , , , , , , , , , , , , , , , , , , , , , , , , , , , , , , ,#, , , , , , , , , , , , , , , , , ,#
 , , , , , , , , , , , , , , , , , , , , , , , , , , , , , , , , , , , , , , , , , , , , , , , , , , , , , , , , , , , , , , , , , ,#, , , , , , , , , , , , , , , , , ,#
 , , , , , , , , , , , , , , , , , , , , , , , , , , , , , , , , , , , , , , , , , , , , , , , , , , , , , , , , , , , , , , , , , ,#, , , , , , , , , , , , , , , , , ,#
 , , , , , , , , , , , , , , , , , , , , , , , , , , , , , , , , , , , , , , , , , , , , , , , , , , , , , , , , , , , , , , , , , ,#, , , , , , , , , , , , , , , , , ,#
 , , , , , , , , , , , , , , , , , , , , , , , , , , , , , , , , , , , , , , , , , , , , , , , , , , , , , , , , , , , , , , , , , ,#, , , , , , , , , , , , , , , , , ,#
 , , , , , , , , , , , , , , , , , , , , , , , , , , , , , , , , , , , , , , , , , , , , , , , , , , , , , , , , , , , , , , , , , ,#, , , , , , , , , , , , , , , , , ,#
 , , , , , , , , , , , , , , , , , , , , , , , , , , , , , , , , , , , , , , , , , , , , , , , , , , , , , , , , , , , , , , , , , ,#, , , , , , , , , , , , , , , , , ,#
 , , , , , , , , , , , , , , , , , , , , , , , , , , , , , , , , , , , , , , , , , , , , , , , , , , , , , , , , , , , , , , , , , ,#, , , , , , , , , , , , , , , , , ,#
 , , , , , , , ,#,#,#,#,#,#,#,#,#,#,#,#,#,#,#,#,#,#,#, , , , , , , , , , , , , , , , , , , , , , , , , , , , , , , , , , , , , , , ,#, , , , , , , , , , , , , , , , , ,#
 , , , , , , , ,#, , , , , , , , ,#, , , ,#, , , , ,#, , , , , , , , , , , , , , , , , , , , , , , , , , , , , , , , , , , ,#,#,#,#,#,#,#,#,#,#,#,#,#,#,#,#,#,#,#,#,#,#,#
 , , , , , , , ,#, , , , , , , , ,#, , , ,#, , , , ,#, , , , , , , , , , , , , , , , , , , , , , , , , , , , , , , , , , , ,#, , , ,#, , , , , ,#, , , , , , ,#, , , , ,#
 , , , , , , , ,#, , , , , , , , ,#, , , ,#,#,#,#,#,#, , , , , , , , , , , , , , , , , , , , , , , , , , , , , , , , , , , ,#, , , ,#, , , , , ,#, , ,CONFERENCE ROOM , , , ,#, , , , ,#
 , , , , , , , ,#, , , , , , , , ,#, , , ,#, , , , ,#, , , , , , , , , , , , , , , , , , , , , , , , , , , , , , , , , , , ,#, , , ,#, , , , , ,#, , , , , , ,#, , , , ,#
 , , , , , , , ,#, , , , , , , , ,#, , , ,#, , , , ,#, , , , , , , , , , , , , , , , , , , , , , , , , , , , , , , , , , , ,#, , , ,#, , , , , ,#,#,#,#,#, ,#,#, , , , ,#
 , , , , , , , ,#,#,#,#,#,#,#,#, ,#, , , ,#,#,#,#, ,#,#,#,#,#,#,#,#,#,#,#,#,#,#,#,#,#,#,#, , , ,#,#,#,#,#,#,#,#,#,#,#,#,#,#,#,#, ,#,#,#,#,#,#,#,#, , , , , , ,#, , , , ,#
 , , , , , , , ,#, , , , , ,#, , , , , , ,#, , , , , , , , , ,#, , , ,#, , , ,#, , , , , , , , , , ,#, , ,#, , , , ,#, , , ,#, , , , ,#, , , , ,#, , , , , , ,#, , , , ,#
 , , , , , , , ,#, , , , , ,#, , , , , , ,#, , , , , , , , , ,#, , , ,#, , , ,#, , , , , , , , , , ,#, , ,#, , , , ,#, , , ,#, ,RH-106, , ,#, ,STORAGE 2 F1, , ,#, , ,EDEN, , , ,#, ,RH-110, , ,#
 , , , , , , , ,#, ,ADMIN, , , , , , , , , , ,#, , , , , , , , , ,#, , , ,#, , , ,#, , , , , , , , , , ,#, , ,#, , , , ,#, , , ,#, , , , ,#, , , , ,#, , , , , , ,#, , , , ,#
 , , , , , , , ,#, , , , , ,#, , ,DPSM FACULTY, , , ,#, , , , , , , , , ,#, , , ,#, , , ,#, , , ,#,#,#,#,#,#,#,#, , ,#, , , , ,#, , , ,#, , , , ,#, , , , ,#,#,#,#,#, ,#,#, , , , ,#
 , , , , , , , ,#, , , , , , , , ,RH-102, , , ,#, , , , ,RH-104, , , , ,#, , , ,#, , , ,#, , , ,#, , , , , , ,#, ,RH-104,#, , , , ,#, , , ,#, , , , ,#, , , , ,#, ,#, , , , ,#, , , , ,#
 , , , , , , , ,#, , , , , ,#, , , , , , ,#, , , , , , , , , ,#,#,#, ,#, ,MALE CR, ,#, , , ,#, , , , , , ,#, ,CASSC,#, , , , , , ,FEMALE CR, ,#, , , , ,#, , , , ,#, ,#,#, , , , , , , , ,#
 , , , , , , , ,#, , , , , ,#, , , , , , ,#, , , , , , , , , ,#, , , ,#, , , ,#, ,St, ,#, , , , , , ,#, , ,#,#,#,#,#,#, , , ,#, , , , ,#, , , , ,#, , , , , , , , , , , ,#
 , , , , , , , ,#,#,#,#,#,#,#,#, , ,#,#,#,#, , , , , , , , , ,#, , , , , , , ,#, , , ,#,#, , , ,#, ,#,#, ,#, , , , , , , , ,#, , , , ,#, , , , ,#,#,#,#, , , ,#,#,#,#,#,#
 , , , , , , , ,#, , , , , , , , , , , , ,#,#,#,#,#,#, ,#,#,#,#, ,#,#,#,#,#,#,#, , , , , , , , , , , , , ,#,#,#,#,#,#,#, ,#,#,#,#, ,#,#,#, ,#,#,#, , , , , , , , , , , ,#
 , , , , , , , ,#, , , , , , , , , , , , , , , , , , , , , , , , , , , , , , , , , , , , , , , , , , , , , , , , , , , , , , , , , , , , , , , , , , , , , , , , , , , ,#
 , , , , , , , , , , , , , , , , , , , , , , , , , , , , , , , , , , , , , , , , , , , , , , , , , , , , , , , , , , , , , , , , , , , , , , , , , , , , , , , , , , , , 
 , , , , , , , , , , , , , , , , , , , , , , , , , , , , , , , , , , , , , , , , , , , , , , , , , , , , , , , , , , , , , , , , , , , , , , , , , , , , , , , , , , ,S, 
 , , , , , , , ,#, , , , , , , , , , , , , , , , , , , , , , , , , , , , , , , , , , , , , , , , , , , , , , , , , , , , , , , , , , , , , , , , , , , , , , , , , , , ,#
 , , , , , , , ,#, , , , , , , , , , , ,#,#,#,#,#, ,#,#, ,#,#,#,#,#,#,#,#, ,#,#, , , , ,#, , , ,#, , , , ,#,#,#,#,#,#,#,#, ,#,#,#,#,#,#,#,#,#, ,#, , , , , , , , , , , ,#
 , , , , , , , ,#,#,#,#,#,#,#,#, ,#,#,#,#, , , , , ,#, , , , ,#, , , , , , , ,#, , , , , , , , , , , , , ,#, , , , , , , , , , , , , ,#, , , , ,#,#,#,#, , ,#,#,#,#,#,#,#
 , , , , , , , ,#, , , , , , , , , , , , , , , , , ,#, , , , ,#, , , , , , , ,#, , , , , , , , , , , , , ,#, , , , , , , , , , , , , , , , , , ,#, , , , , , , , , , , ,#
 , , , , , , , ,#, , , , , , , , , , , , ,#,#,#, , ,#, , , , ,#, , , , , , , ,#, , , , , , , , , , , , , ,#, , , , , , , , , , , , , ,#, , , , ,#, ,#,#,#,#,#,#, , , , ,#
 , , , , , , , ,#, , , , , , , , , , , , ,#, ,#, , , , , , , ,#, , ,RH-105, , , , ,#, , , , , , , , , , , , , ,#, , , , , , , , , , , , , ,#, , , , ,#, ,#, , , , , , , , , ,#
 , , , , , , , ,#,#,#,#, ,#,#,#,#,#,#,#,#,#, ,#, ,ADMIN OFFICE, , , , , ,#, , ,ASSOCIATE DEANS, , , , ,#, , , , , , , , , , , , , ,#, , , , , , , ,RH 107, , , , , ,#,#,#,#,#,#, ,#, , , , , , , , , ,#
 , , , , , , , ,#, , , , , , , , ,#, , , ,#, ,#, ,RH-103, , , , , ,#, , , , , , , ,#, , , , , , , , , , , , , ,#, , , , , , , ,OCS, , , , , , , , , , ,#, ,#, , , , , , , , , ,#
 , , , , , , , ,#, , , , , , , , ,#, , , ,#, ,#, , , , , , , ,#, , , , , , , ,#, , , , , , , , , , , , , ,#, , , , , , , , , , , , , , , , , , ,#, ,#, , , , , , , , , ,#
 , , , , , , , ,#, , , , , , , , ,#,#,#,#,#, , , , , , , , , ,#, , , , , , , ,#, , , , , , , , , , , , , ,#, , , , , , , , , , , , , , , , , , ,#, ,#, , , ,DAC FACULTY, , , , , ,#
 , , , , , , , ,#, , , , , , , , ,#, , , ,#, , , , , , , , , ,#, , , , , , , ,#, , , , , , , , , , , , , ,#, , , , , , , , , , , , , , , , , , ,#, , , , , ,RH-109, , , , , ,#
 , , , , , , , ,#, , , ,DEAN'S OFFICE, , , , ,#,#,#,#,#,#,#,#,#,#,#,#,#,#,#,#,#,#,#,#,#,#,#,#, , ,#,#,#, , ,#,#, , ,#,#,#,#,#,#,#,#,#,#,#,#,#,#,#,#,#,#,#,#,#, ,#, , , , , , , , , ,#
 , , , , , , , ,#, , , ,RH-101, , , , ,#, , , ,#, , , , , , , , , , , , , , , , , , , , , , , , , , , , , , , , , , , , , , , , , , , , , , , , , , ,#, , , , , , , , , , , ,#
 , , , , , , , ,#, , , , , , , , ,#, , , ,#, , , , , , , , , , , , , , , , , , , , , , , , , , , , , , , , , , , , , , , , , , , , , , , , , , ,#, ,#, , , , , , , , , ,#
 , , , , , , , ,#, , , , , , , , ,#, , , ,#, , , , , , , , , , , , , , , , , , , , , , , , , , , , , , , , , , , , , , , , , , , , , , , , , , ,#, ,#, , , , , , , , , ,#
 , , , , , , , ,#, , , , , , , , ,#, ,#,#,#, , , , , , , , , , , , , , , , , , , , , , , , , , , , , , , , , , , , , , , , , , , , , , , , , , ,#, ,#, , , , , , , , , ,#
 , , , , , , , ,#, , , , , , , , , , , , ,#, , , , , , , , , , , , , , , , , , , , , , , , , , , , , , , , , , , , , , , , , , , , , , , , , , ,#, ,#, , , , , , , , , ,#
 , , , , , , , ,#,#,#,#,#,#,#,#,#,#,#,#,#,#, , , , , , , , , , , , , , , , , , , , , , , , , , , , , , , , , , , , , , , , , , , , , , , , , , ,#,#,#,#,#,#,#,#,#,#,#,#,#
