 , , , , , , , , , , , , , , , , , , , , , , , , , , , , , , , , , , , , , , , , , , , , , , , , , , , , , , , , , , , , ,#,#,#,#, , , , , , , , , , , , , 
 , , , , , , , , , , , , , , , , , , , , , , , , , , , , , , , , , , , , , , , , , , , , , , , , , , , , , , , , , , , , ,#, , , , , , , , , , , , , , , , 
 , , , , , , , , , , , , , , , , , , , , , , , , , , , , , , , , , , , , , , , , , , , , , , , , , , , , , , , , , , , , ,#, , ,#, , , , , , , , , , , , , 
 , , , , , , , , , , , , , , ,#,#,#,#,#,#,#,#,#,#,#,#,#,#,#,#,#,#,#,#,#,#,#,#,#,#,#,#,#,#,#,#,#,#,#,#,#,#,#,#,#,#,#,#,#,#,#, , ,#, , , , , , , , , , , , , 
 , , , , , , , , , , , , , , ,#, , , , ,#, , , , , , , , , , , , , ,#, , , , , , , , , , , , , ,#, , , , ,#, , , , , , , , , , ,#, , , , , , , , , , , , , 
 , , , , , , , , , , , , , , ,#, , , , ,#, , , , , , , , , , , , , ,#, , , , , , , , , , , , , ,#, , , , ,#, , , , , , , , , , ,#, , , , , , , , , , , , , 
 , , , , , , , , , , , , , , ,#, , , , ,#, , , , , , , , , , , , , ,#, , , , , , , , , , , , , ,#,#,#,#, ,#, , , , , ,#,#,#, , ,#, , , , , , , , , , , , , 
 , , , , , , , , , , , , , , ,#, , , , ,#, , , , , , , , , , , , , ,#, , , , , , , , , , , , , ,#, , ,#, ,#, , , , , ,#, ,#, , ,#, , , , , , , , , , , , , 
 , , , , , , , , , , , , , , ,#, , , , ,#, , , , , , , , , , , , , , , , , , , , , , , , , , , ,#, , , , , , , , , , ,#, ,#, , ,#, , , , , , , , , , , , , 
 , , , , , , , , , , , , , , ,#,#,#,#, ,#,#,#,#, ,#,#,#,#,#,#, ,#,#,#,#,#,#, ,#,#,#, ,#,#,#,#,#,#,#,#,#,#,#, , , , , ,#, ,#, , ,#, , , , , , , , , , , , , 
 , , , , , , , , , , , , , , ,#, , , , , , , , , , , , , , , , , , , , , , , , , , , , , , , , , , , , , , , , , , , ,#, ,#,#,#,#, , , , , , , , , , , , , 
 , , , , , , , , , , , , , , ,#, , , , , , , , , , , , , , , , , , , , , , , , , , , , , , , , , , , , , , , , , , , ,#, ,#,#,#,#, , , , , , , , , , , , , 
 , , , , , , , , , , , , , , ,#, , , , , , , , , , , , , , , , , , , , , , , , , , , , , , , , , , , , , , , , , , , ,#, ,#, , ,#, , , , , , , , , , , , , 
 , , , , , , , , , , , , , , ,#,#,#,#, ,#,#,#,#,#,#,#, , ,#,#,#,#,#,#,#, , ,#,#,#, ,#,#,#,#,#,#,#,#, , ,#,#, , , , , ,#, ,#, , ,#, , , , , , , , , , , , , 
 , , , , , , , , , , , , , , ,#, , , , , ,#, , , , , , , , ,#, , , , , , , , ,#, , , , , , , , , , , , , ,#, , , , , ,#, ,#, , ,#, , , , , , , , , , , , , 
 , , , , , , , , , , , , , , ,#, , , , , ,#, , , , , , , , ,#, , , , , , , , ,#, , , , , , , , , , , , , ,#, , , , , ,#,#,#, , ,#, , , , , , , , , , , , , 
 , , , , , , , , , , , , , , ,#, , , , , ,#, , , , , , , , ,#, , , , , , , , ,#, , , , , , , , , , , , , ,#, , , , , , , , , , ,#, , , , , , , , , , , , , 
 , , , , , , , , , , , , , , ,#, , , , , ,#, , , , , , , , ,#, , , , , , , , ,#, , , , , , , , , , , , , ,#, , , , , , , , , , ,#, , , , , , , , , , , , , 
 , , , , , , , , , , , , , , ,#, , , , , ,#, , , , , , , , ,#, , , , , , , , ,#, , , , , , , , , , , , , ,#, , , , ,#,#,#,#,#,#,#,#,#,#,#,#,#,#,#,#,#,#,#,#
 , , , , , , , , , , , , , , ,#, , , , , ,#, , , , , , , , ,#, , , , , , , , ,#, , , , , , , , , , , , , ,#, , , , , , , , , , ,#, , , , , , , , , , , , ,#
 , , , , , , , , , , , , , , ,#, , , , , ,#, , , , , , , , ,#, , , , , , , , ,#, , , , , , , , , , , , , ,#, , , , , , , , , , ,#, , , , , , , , , , , , ,#
 , , , , , , , , , , , , , , ,#, , , , , ,#, , , , , , , , ,#, , , , , , , , ,#, , , , , , , , , , , , , ,#, , , , , , , , , , ,#, , , , , , , , , , , , ,#
 , , , , , , , , , , , , , , ,#,#,#,#,#,#,#,#,#,#,#,#, ,#,#,#,#,#,#,#,#,#,#,#,#,#,#,#,#,#,#,#,#,#,#,#,#,#,#,#,#,#,#,#, , , , , ,#, , , , , , , , , , , , ,#
 , , , , , , , , , , , , , , , , , , , , , , , , , , , , , , , , , , , , , , , , , , , , , , , , , , , , , , , , , ,#, , , , , ,#, , , , , , , , , , , , ,#
 , , , , , , , , , , , , , , , , , , , , , , , , , , , , , , , , , , , , , , , , , , , , , , , , , , , , , , , , , ,#, , , , , ,#, , , , , , , , , , , , ,#
 , , , , , , , , , , , , , , , , , , , , , , , , , , , , , , , , , , , , , , , , , , , , , , , , , , , , , , , , , ,#, , , , , ,#, , , , , , , , , , , , ,#
 , , , , , , , , , , , , , , , , , , , , , , , , , , , , , , , , , , , , , , , , , , , , , , , , , , , , , , , , , ,#, , , , , ,#, , , , , , , , , , , , ,#
 , , , , , , , , , , , , , , , , , , , , , , , , , , , , , , , , , , , , , , , , , , , , , , , , , , , , , , , , , ,#, , , , , ,#, , , , , , , , , , , , ,#
 , , , , , , , , , , , , , , , , , , , , , , , , , , , , , , , , , , , , , , , , , , , , , , , , , , , , , , , , , ,#, , , , , ,#,#,#,#,#,#,#,#,#,#,#,#,#,#
 , , , , , , , , , , , , , , , , , , , , , , , , , , , , , , , , , , , , , , , , , , , , , , , , , , , , , , , , , ,#, , , , , ,#, , , , , , , , , , , , ,#
 , , , , , , , , , , , , , , , , , , , , , , , , , , , , , , , , , , , , , , , , , , , , , , , , , , , , , , , , , ,#, , , , , ,#, , , , , , , , , , , , ,#
 , , , , , , , , , , , , , , , , , , , , , , , , , , , , , , , , , , , , , , , , , , , , , , , , , , , , , , , , , ,#, , , , , ,#, , , , , , , , , , , , ,#
 , , , , , , , , , , , , , , , , , , , , , , , , , , , , , , , , , , , , , , , , , , , , , , , , , , , , , , , , , ,#, , , , , ,#, , , , , , , , , , , , ,#
 , , , , , , , , , , , , , , , , , , , , , , , , , , , , , , , , , , , , , , , , , , , , , , , , , , , , , , , , , ,#, , , , , ,#, , , , , , , , , , , , ,#
 , , , , , , , , , , , , , , , , , , , , , , , , , , , , , , , , , , , , , , , , , , , , , , , , , , , , , , , , , ,#, , , , , ,#, , , , , , , , , , , , ,#
 , , , , , , , , , , , , , , , , , , , , , , , , , , , , , , , , , , , , , , , , , , , , , , , , , , , , , , , , , ,#, , , , , ,#, , , , , , , , , , , , ,#
 , , , , , , , , , , , , , , , , , , , , , , , , , , , , , , , , , , , , , , , , , , , , , , , , , , , , , , , , , ,#, , , , , ,#, , , , , , , , , , , , ,#
 , , , , , , , , , , , , , , , , , , , , , , , , , , , , , , , , , , , , , , , , , , , , , , , , , , , , , , , , , ,#, , , , , , , , , , , , , , , , , , ,#
 , , , , , , , , , , , , , , , , , , , , , , , , , , , , , , , , , , , , , , , , , , , , , , , , , , , , , , , , , ,#, , , , , ,#,#,#,#,#,#,#,#,#,#,#,#,#,#
 , , , , , , , , , , , , , , , , , , , , , , , , , , , , , , , , , , , , , , , , , , , , , , , , , , , , , , , , , ,#, , , , , ,#, , , , , , , , , , , , ,#
 , , , , , , , , , , , , , , , , , , , , , , , , , , , , , , , , , , , , , , , , , , , , , , , , , , , , , , , , , ,#, , , , , ,#, , , , , , , , , , , , ,#
 , , , , , , , , , , , , , , , , , , , , , , , , , , , , , , , , , , , , , , , , , , , , , , , , , , , , , , , , , ,#, , , , , ,#, , , , , , , , , , , , ,#
 , , , , , , , , , , , , , , , , , , , , , , , , , , , , , , , , , , , , , , , , , , , , , , , , , , , , , , , , , ,#, , , , , ,#, , , , , , , , , , , , ,#
 , , , , , , , , , , , , , , , , , , , , , , , , , , , , , , , , , , , , , , , , , , , , , , , , , , , , , , , , , ,#, , , , , ,#, , , , , , , , , , , , ,#
 , , , , , , , , , , , , , , , , , , , , , , , , , , , , , , , , , , , , , , , , , , , , , , , , , , , , , , , , , ,#, , , , , ,#, , , , , , , , , , , , ,#
 , , , , , , , , , , , , , , , , , , , , , , , , , , , , , , , , , , , , , , , , , , , , , , , , , , , , , , , , , ,#, , , , , ,#, , , , , , , , , , , , ,#
 , , , , , , , , , , , , , , , , , , , , , , , , , , , , , , , , , , , , , , , , , , , , , , , , , , , , , , , , , ,#, , , , , ,#, , , , , , , , , , , , ,#
 , , , , , , , , , , , , , , , , , , , , , , , , , , , , , , , , , , , , , , , , , , , , , , , , , , , , , , , , , ,#, , , , , , , , , , , , , , , , , , ,#
 , , , , , , , , , , , , , , , , , , , , , , , , , , , , , , , , , , , , , , , , , , , , , , , , , , , , , , , , , ,#, , , , , ,#,#,#,#,#,#,#,#,#,#,#,#,#,#
 , , , , , , , , , , , , , , , , , , , , , , , , , , , , , , , , , , , , , , , , , , , , , , , , , , , , , , , , , ,#, , , , , , , , , , , , , , , , , , ,#
 , , , , , , , , , , , , , , , , , , , , , , , , , , , , , , , , , , , , , , , , , , , , , , , , , , , , , , , , , ,#, , , , , ,#, , , , , , , , , , , , ,#
 , , , , , , , , , , , , , , , , , , , , , , , , , , , , , , , , , , , , , , , , , , , , , , , , , , , , , , , , , ,#, , , , , ,#, , , , , , , , , , , , ,#
 , , , , , , , , , , , , , , , , , , , , , , , , , , , , , , , , , , , , , , , , , , , , , , , , , , , , , , , , , ,#, , , , , ,#, , , , , , , , , , , , ,#
 , , , , , , , , , , , , , , , , , , , , , , , , , , , , , , , , , , , , , , , , , , , , , , , , , , , , , , , , , ,#, , , , , ,#, , , , , , , , , , , , ,#
 , , , , , , , , , , , , , , , , , , , , , , , , , , , , , , , , , , , , , , , , , , , , , , , , , , , , , , , , , ,#, , , , , ,#, , , , , , , , , , , , ,#
 , , , , , , , , , , , , , , , , , , , , , , , , , , , , , , , , , , , , , , , , , , , , , , , , , , , , , , , , , ,#, , , , , ,#, , , , , , , , , , , , ,#
 , , , , , , , , , , , , , , , , , , , , , , , , , , , , , , , , , , , , , , , , , , , , , , , , , , , , , , , , , ,#, , , , , ,#, , , , , , , , , , , , ,#
#,#,#,#,#,#,#,#,#,#,#,#,#,#, , , , , , , , , , , , , , , , , , , , , , , , , , , , , , , , , , , , , , , , , , , , ,#, , , , , ,#,#,#,#,#,#,#,#,#,#,#,#,#,#
#, , , , , , , , , , , , ,#, , , , , , , , , , , , , , , , , , , , , , , , , , , , , , , , , , , , , , , , , , , , ,#, , , , , , , , , , , , , , , , , , ,#
#, , , , , , , , , , , , ,#, , , , , , , , , , , , , , , , , , , , , , , , , , , , , , , , , , , , , , , , , , , , ,#, , , , , , , , , , , , , , , , , , ,#
#, , , , , , , , , , , , ,#, , , , , , , , , , , , , , , , , , , , , , , , , , , , , , , , , , , , , , , , , , , , ,#, , , , , ,#, , , , , , , , , , , , ,#
#, , , , , , , , , , , , ,#, , , , , , , , , , , , , , , , , , , , , , , , , , , , , , , , , , , , , , , , , , , , ,#, , , , , ,#, , , , , , , , , , , , ,#
#, , , , , , , , , , , , ,#, , , , , , , , , , , , , , , , , , , , , , , , , , , , , , , , , , , , , , , , , , , , ,#, , , , , ,#, , , , , , , , , , , , ,#
#, , , , , , , , , , , , ,#,#,#,#,#,#,#,#,#,#,#,#,#,#,#,#,#,#,#,#,#,#,#,#,#,#,#,#,#,#,#,#,#,#,#,#,#,#,#,#,#,#,#,#,#,#, , , , , ,#, , , , , , , , , , , , ,#
#, , , , , , , , , , , , ,#, , , , , , , , ,#, , , , ,#, , , ,#, , , , , , ,#, , , , , , ,#, , , , ,#, , , ,#, , , ,#, , , , , ,#, , , , , , , , , , , , ,#
#, , , , , , , , , , , , ,#, , , , , , , , ,#, , , , ,#, , , ,#, , , , , , ,#, , , , , , ,#, , , , ,#, , , ,#, , , ,#, , , , , ,#, , , , , , , , , , , , ,#
#, , , , , , , , , , , , ,#, , , , , , , , ,#, , , , ,#, , , ,#, , , ,#,#,#,#,#,#,#, , , ,#, , , , ,#, , , ,#, , , ,#, , , , , ,#, , , , , , , , , , , , ,#
#, , , , , , , , , , , , ,#, , , , , , , , ,#, , , , ,#, , , ,#, , , ,#, , , , , ,#, , , ,#, , , , ,#, , , ,#, , , ,#, , , , , ,#, , , , , , , , , , , , ,#
#, , , , , , , , , , , , ,#, , , , , , , , ,#, , , , ,#, , , ,#, , , ,#, , , , , ,#, , , ,#, , , , ,#, , , ,#, , , ,#, , , , , ,#, , , , , , , , , , , , ,#
#, , , , , , , , , , , , ,#, , , , , , , , ,#, , , ,#,#,#, , ,#, , , ,#, , , , , ,#, , , ,#,#,#,#, ,#,#, ,#,#, , , ,#, , , , , ,#, , , , , , , , , , , , ,#
#, , , , , , , , , , , , ,#, , , , , , , , ,#, , , ,#, ,#, , ,#, , , ,#, , , , , ,#, , , ,#, , ,#, , , , , ,#, , , ,#, , , , , ,#, , , , , , , , , , , , ,#
#, , , , , , , , , , , , ,#, , , , , , , , ,#, , , , , ,#, , ,#, , , , , , , , , , , , , ,#, , ,#, , , , , ,#, , , ,#, , , , , ,#, , , , , , , , , , , , ,#
#, , , , , , , , , , , , ,#,#,#, ,#,#,#,#,#,#,#, ,#,#,#,#,#, ,#, , , , , , , , , , , , , ,#,#, ,#,#,#,#, ,#,#,#, ,#,#, , , , , ,#, , , , , , , , , , , , ,#
#, , , , , , , , , , , , ,#, , , , , , , , , , , , , ,#, , , , , , , , , , , , , , , , , , , , , , , , , , , , , , , , , , , , ,#, , , , , , , , , , , , ,#
#, , , , , , , , , , , , , , , , , , , , , , , , , , , , , , , , , , , , , , , , , , , , , , , , , , , , , , , , , , , , , , , , , , , , , , , , , , , , ,#
#, , , , , , , , , , , , , , , , , , , , , , , , , , , , , , , , , , , , , , , , , , , , , , , , , , , , , , , , , , , , , , , , , , , , , , , , , , , , ,#
#, , , , , , , , , , , , ,#, , , , , , , , , , , , , ,#, , , , , , , , , , , , , , , , , , , , , , , , , , , , , , , , , , , , ,#, , , , , , , , , , , , ,#
#, , , , , , , , , , , , ,#, , ,#,#,#, , ,#,#,#, , ,#,#,#,#,#,#,#, , ,#,#,#,#,#,#,#, , ,#,#,#,#,#,#,#, , ,#,#,#,#,#,#,#,#,#,#,#,#,#,#,#,#,#,#,#,#,#,#,#,#,#
#, , , , , , , , , , , , ,#, , , , , , , , , , , , , , , , , , , , , , , , , , , , , , , , , , , , , , , , , , , , , , , , , , ,#, , , , , , , , , , , , ,#
#, , , , , , , , , , , , ,#, , , , , , , , , , , , , , , , , , , , , , , , , , , , , , , , , , , , , , , , , , , , , , , , , , ,#, , , , , , , , , , , , ,#
#, , , , , , , , , , , , ,#, , , , , , , , , , , , , , , , , , , , , , , , , , , , , , , , , , , , , , , , , , , , , , , , , , ,#, , , , , , , , , , , , ,#
#, , , , , , , , , , , , ,#, , , , , , , , , , , , , , , , , , , , , , , , , , , , , , , , , , , , , , , , , , , , , , , , , , ,#, , , , , , , , , , , , ,#
#, , , , , , , , , , , , ,#, , , , , , , , , , , , , , , , , , , , , , , , , , , , , , , , , , , , , , , , , , , , , , , , , , ,#, , , , , , , , , , , , ,#
#, , , , , , , , , , , , ,#, , , , , , , , , , , , , , , , , , , , , , , , , , , , , , , , , , , , , , , , , , , , , , , , , , ,#, , , , , , , , , , , , ,#
#, , , , , , , , , , , , ,#, , , , , , , , , , , , , , , , , , , , , , , , , , , , , , , , , , , , , , , , , , , , , , , , , , , , , , , , , , , , , , , ,#
#, , , , , , , , , , , , , , , , , , , , , , , , , , , , , , , , , , , , , , , , , , , , , , , , , , , , , , , , , , , , , , , ,#, , , , , , , , , , , , ,#
#, , , , , , , , , , , , ,#, , , , , , , , , , , , , , , , , , , , , , , , , , , , , , , , , , , , , , , , , , , , , , , , , , ,#, , , , , , , , , , , , ,#
#, , , , , , , , , , , , ,#,#,#,#,#,#,#,#,#,#,#,#,#,#,#,#,#,#,#,#,#,#,#,#,#,#,#,#,#,#,#,#,#,#,#,#,#,#,#,#,#,#,#,#,#,#,#,#,#,#,#,#, , , , , , , , , , , , ,#
#, , , , , , , , , , , , ,#, , , , , , , , , , , , , , , , , , , , , , , , , , , , , , , , , , , , , , , , , , , , , , , , , , ,#, , , , , , , , , , , , ,#
#, , , , , , , , , , , , ,#, , , , , , , , , , , , , , , , , , , , , , , , , , , , , , , , , , , , , , , , , , , , , , , , , , ,#, , , , , , , , , , , , ,#
#, , , , , , , , , , , , ,#, , , , , , , , , , , , , , , , , , , , , , , , , , , , , , , , , , , , , , , , , , , , , , , , , , ,#, , , , , , , , , , , , ,#
#, , , , , , , , , , , , ,#, , , , , , , , , , , , , , , , , , , , , , , , , , , , , , , , , , , , , , , , , , , , , , , , , , ,#, , , , , , , , , , , , ,#
#, , , , , , , , , , , , ,#, , , , , , , , , , , , , , , , , , , , , , , , , , , , , , , , , , , , , , , , , , , , , , , , , , ,#, , , , , , , , , , , , ,#
#,#,#,#,#,#,#,#,#,#,#,#,#,#, , , , , , , , , , , , , , , , , , , , , , , , , , , , , , , , , , , , , , , , , , , , , , , , , , ,#,#,#,#,#,#,#,#,#,#,#,#,#,#
