 , , , , , , , , , , , , , , , , , , , , , , , , , , , , , , , , , , , , , , , , , , , , , , , , , , , , , , , , , , , , ,#,#,#,#, , , , , , , , , , , , , 
 , , , , , , , , , , , , , , , , , , , , , , , , , , , , , , , , , , , , , , , , , , , , , , , , , , , , , , , , , , , , ,#, , , , , , , , , , , , , , , , 
 , , , , , , , , , , , , , , , , , , , , , , , , , , , , , , , , , , , , , , , , , , , , , , , , , , , , , , , , , , , , ,#, , ,#, , , , , , , , , , , , , 
 , , , , , , , , , , , , , , ,#,#,#,#,#,#,#,#,#,#,#,#,#,#,#,#,#,#,#,#,#,#,#,#,#,#,#,#,#,#,#,#,#,#,#,#,#,#,#,#,#,#,#,#,#,#,#, , ,#, , , , , , , , , , , , , 
 , , , , , , , , , , , , , , ,#, , , , , , , , , , , , , , ,#, , , ,#, , , , , , , , , , , , , ,#, , , , ,#, , , , , , , , , , ,#, , , , , , , , , , , , , 
 , , , , , , , , , , , , , , ,#, , , , , , , , , , , , , , ,#, , , ,#, , , , , , , , , , , , , ,#, , , , ,#, , , , , , , , , , ,#, , , , , , , , , , , , , 
 , , , , , , , , , , , , , , ,#, , , , , , , , , , , , , , ,#, , , ,#, , , , , , , , , , , , , ,#,#,#,#, ,#, , , , , ,#,#,#, , ,#, , , , , , , , , , , , , 
 , , , , , , , , , , , , , , ,#, , , , , , , , , , , , , , ,#, , , ,#, , , , , , , , , , , , , ,#, , ,#, ,#, , , , , ,#, ,#, , ,#, , , , , , , , , , , , , 
 , , , , , , , , , , , , , , ,#, , , , , , , , , , , , , , ,#, , , ,#, , , , , , , , , , , , , ,#, , , , , , , , , , ,#, ,#, , ,#, , , , , , , , , , , , , 
 , , , , , , , , , , , , , , ,#,#,#,#, ,#,#, ,#,#,#,#,#,#,#,#,#, ,#,#,#,#, ,#,#,#,#,#,#,#,#, ,#,#,#,#,#,#,#, , , , , ,#, ,#, , ,#, , , , , , , , , , , , , 
 , , , , , , , , , , , , , , ,#, , , , , , , , , , , , , , , , , , , , , , , , , , , , , , , , , , , , , ,#, , , , , ,#, ,#, , ,#, , , , , , , , , , , , , 
 , , , , , , , , , , , , , , ,#, , , , , , , , , , , , , , , , , , , , , , , , , , , , , , , , , , , , , ,#, , , , , ,#, ,#, , ,#, , , , , , , , , , , , , 
 , , , , , , , , , , , , , , ,#, , , , , , , , , , , , , , , , , , , , , , , , , , , , , , , , , , , , , ,#, , , , , ,#, ,#, , ,#, , , , , , , , , , , , , 
 , , , , , , , , , , , , , , ,#,#,#,#, ,#,#,#, ,#,#,#,#,#,#,#,#, ,#,#,#, ,#,#,#, ,#,#,#,#,#,#,#,#,#,#,#, ,#, , , , , ,#, ,#, , ,#, , , , , , , , , , , , , 
 , , , , , , , , , , , , , , ,#, , , , , ,#, , , , , , , , , , , , ,#, , , , , , , , , , , , , ,#, , , , ,#, , , , , ,#,#,#, , ,#, , , , , , , , , , , , , 
 , , , , , , , , , , , , , , ,#, , , , , ,#, , , , , , , , , , , , ,#, , , , , , , , , , , , , ,#, , , , ,#, , , , , ,#, , , , ,#, , , , , , , , , , , , , 
 , , , , , , , , , , , , , , ,#, , , , , ,#, , , , , , , , , , , , ,#, , , , , , , , , , , , , ,#, , , , ,#, , , , , ,#, , , , ,#, , , , , , , , , , , , , 
 , , , , , , , , , , , , , , ,#, , , , , ,#, , , , , , , , , , , , ,#, , , , , , , , , , , , , ,#, , , , ,#, , , , , ,#,#,#,#,#,#,#,#,#,#,#,#,#,#,#,#,#,#,#
 , , , , , , , , , , , , , , ,#, , , , , ,#, , , , , , , , , , , , ,#, , , , , , , , , , , , , ,#, , , , ,#, , , , , , , , , , ,#, , , , , , , , , , , , ,#
 , , , , , , , , , , , , , , ,#, , , , , ,#, , , , , , , , , , , , ,#, , , , , , , , , , , , , ,#, , , , ,#, , , , , , , , , , ,#, , , , , , , , , , , , ,#
 , , , , , , , , , , , , , , ,#, , , , , ,#, , , , , , , , , , , , ,#, , , , , , , , , , , , , ,#, , , , ,#, , , , , , , , , , ,#, , , , , , , , , , , , ,#
 , , , , , , , , , , , , , , ,#, , , , , ,#, , , , , , , , , , , , ,#, , , , , , , , , , , , , ,#, , , , ,#, , , , , , , , , , ,#, , , , , , , , , , , , ,#
 , , , , , , , , , , , , , , ,#,#,#,#,#,#,#,#,#,#,#,#,#,#,#,#,#,#,#,#,#,#,#,#,#,#,#,#,#,#,#,#,#,#,#,#,#,#,#,#,#,#,#,#, , , , , ,#, , , , , , , , , , , , ,#
 , , , , , , , , , , , , , , , , , , , , , , , , , , , , , , , , , , , , , , , , , , , , , , , , , , , , , , , , , ,#, , , , , ,#, ,#,#,#,#,#,#,#,#,#,#,#,#
 , , , , , , , , , , , , , , , , , , , , , , , , , , , , , , , , , , , , , , , , , , , , , , , , , , , , , , , , , ,#, , , , , , , , , , , , , , , , , , ,#
 , , , , , , , , , , , , , , , , , , , , , , , , , , , , , , , , , , , , , , , , , , , , , , , , , , , , , , , , , ,#, , , , , ,#, , , , , , , , , , , , ,#
 , , , , , , , , , , , , , , , , , , , , , , , , , , , , , , , , , , , , , , , , , , , , , , , , , , , , , , , , , ,#, , , , , ,#, , , , , , , , , , , , ,#
 , , , , , , , , , , , , , , , , , , , , , , , , , , , , , , , , , , , , , , , , , , , , , , , , , , , , , , , , , ,#, , , , , ,#, , , , , , , , , , , , ,#
 , , , , , , , , , , , , , , , , , , , , , , , , , , , , , , , , , , , , , , , , , , , , , , , , , , , , , , , , , ,#, , , , , ,#, , , , , , , , , , , , ,#
 , , , , , , , , , , , , , , , , , , , , , , , , , , , , , , , , , , , , , , , , , , , , , , , , , , , , , , , , , ,#, , , , , ,#, , , , , , , , , , , , ,#
 , , , , , , , , , , , , , , , , , , , , , , , , , , , , , , , , , , , , , , , , , , , , , , , , , , , , , , , , , ,#, , , , , ,#, , , , , , , , , , , , ,#
 , , , , , , , , , , , , , , , , , , , , , , , , , , , , , , , , , , , , , , , , , , , , , , , , , , , , , , , , , ,#, , , , , ,#, , , , , , , , , , , , ,#
 , , , , , , , , , , , , , , , , , , , , , , , , , , , , , , , , , , , , , , , , , , , , , , , , , , , , , , , , , ,#, , , , , ,#, , , , , , , , , , , , ,#
 , , , , , , , , , , , , , , , , , , , , , , , , , , , , , , , , , , , , , , , , , , , , , , , , , , , , , , , , , ,#, , , , , ,#, , , , , , , , , , , , ,#
 , , , , , , , , , , , , , , , , , , , , , , , , , , , , , , , , , , , , , , , , , , , , , , , , , , , , , , , , , ,#, , , , , ,#,#,#,#,#,#,#,#,#,#,#,#,#,#
 , , , , , , , , , , , , , , , , , , , , , , , , , , , , , , , , , , , , , , , , , , , , , , , , , , , , , , , , , ,#, , , , , ,#, , , , , , , , , , , , ,#
 , , , , , , , , , , , , , , , , , , , , , , , , , , , , , , , , , , , , , , , , , , , , , , , , , , , , , , , , , ,#, , , , , ,#, , , , , , , , , , , , ,#
 , , , , , , , , , , , , , , , , , , , , , , , , , , , , , , , , , , , , , , , , , , , , , , , , , , , , , , , , , ,#, , , , , ,#, , , , , , , , , , , , ,#
 , , , , , , , , , , , , , , , , , , , , , , , , , , , , , , , , , , , , , , , , , , , , , , , , , , , , , , , , , ,#, , , , , , , , , , , , , , , , , , ,#
 , , , , , , , , , , , , , , , , , , , , , , , , , , , , , , , , , , , , , , , , , , , , , , , , , , , , , , , , , ,#, , , , , , , , , , , , , , , , , , ,#
 , , , , , , , , , , , , , , , , , , , , , , , , , , , , , , , , , , , , , , , , , , , , , , , , , , , , , , , , , ,#, , , , , ,#, , , , , , , , , , , , ,#
 , , , , , , , , , , , , , , , , , , , , , , , , , , , , , , , , , , , , , , , , , , , , , , , , , , , , , , , , , ,#, , , , , ,#, , , , , , , , , , , , ,#
 , , , , , , , , , , , , , , , , , , , , , , , , , , , , , , , , , , , , , , , , , , , , , , , , , , , , , , , , , ,#, , , , , ,#, , , , , , , , , , , , ,#
 , , , , , , , , , , , , , , , , , , , , , , , , , , , , , , , , , , , , , , , , , , , , , , , , , , , , , , , , , ,#, , , , , ,#,#,#,#,#,#,#,#,#,#,#,#,#,#
 , , , , , , , , , , , , , , , , , , , , , , , , , , , , , , , , , , , , , , , , , , , , , , , , , , , , , , , , , ,#, , , , , ,#, , , , , , , ,#, , , , ,#
 , , , , , , , , , , , , , , , , , , , , , , , , , , , , , , , , , , , , , , , , , , , , , , , , , , , , , , , , , ,#, , , , , ,#, , , , , , , ,#, , , , ,#
 , , , , , , , , , , , , , , , , , , , , , , , , , , , , , , , , , , , , , , , , , , , , , , , , , , , , , , , , , ,#, , , , , ,#, , , , , , , ,#, , , , ,#
 , , , , , , , , , , , , , , , , , , , , , , , , , , , , , , , , , , , , , , , , , , , , , , , , , , , , , , , , , ,#, , , , , ,#, , , , , , , ,#, , , , ,#
 , , , , , , , , , , , , , , , , , , , , , , , , , , , , , , , , , , , , , , , , , , , , , , , , , , , , , , , , , ,#, , , , , ,#, , , , , , , ,#, , , , ,#
 , , , , , , , , , , , , , , , , , , , , , , , , , , , , , , , , , , , , , , , , , , , , , , , , , , , , , , , , , ,#, , , , , , , , , , , , , ,#, , , , ,#
 , , , , , , , , , , , , , , , , , , , , , , , , , , , , , , , , , , , , , , , , , , , , , , , , , , , , , , , , , ,#, , , , , , , , , , , , , ,#, , , , ,#
 , , , , , , , , , , , , , , , , , , , , , , , , , , , , , , , , , , , , , , , , , , , , , , , , , , , , , , , , , ,#, , , , , ,#, , , , , , , , , , , , ,#
 , , , , , , , , , , , , , , , , , , , , , , , , , , , , , , , , , , , , , , , , , , , , , , , , , , , , , , , , , ,#, , , , , ,#, , , , , , , ,#, , , , ,#
 , , , , , , , , , , , , , , , , , , , , , , , , , , , , , , , , , , , , , , , , , , , , , , , , , , , , , , , , , ,#, , , , , ,#,#,#,#,#,#,#,#,#,#,#,#,#,#
 , , , , , , , , , , , , , , , , , , , , , , , , , , , , , , , , , , , , , , , , , , , , , , , , , , , , , , , , , ,#, , , , , ,#, , , , , , , , , , , , ,#
 , , , , , , , , , , , , , , , , , , , , , , , , , , , , , , , , , , , , , , , , , , , , , , , , , , , , , , , , , ,#, , , , , , , , , , , , , , , , , , ,#
 , , , , , , , , , , , , , , , , , , , , , , , , , , , , , , , , , , , , , , , , , , , , , , , , , , , , , , , , , ,#, , , , , , , , , , , , , , , , , , ,#
#,#,#,#,#,#,#,#,#,#,#,#,#,#,#,#,#,#,#, , , , , , , , , , , , , , , , , , , , , , , , , , , , , , , , , , , , , , , ,#, , , , , ,#,#,#,#,#,#,#,#,#,#,#,#,#,#
#, , , , , , , , , , , , ,#, , , , ,#, , , , , , , , , , , , , , , , , , , , , , , , , , , , , , , , , , , , , , , ,#, , , , , ,#, , , , , , , ,#, , , , ,#
#, , , , , , , , , , , , ,#, , , , ,#, , , , , , , , , , , , , , , , , , , , , , , , , , , , , , , , , , , , , , , ,#, , , , , ,#, , , , , , , ,#, , , , ,#
#, , , , , , , , , , , , ,#, , , , ,#, , , , , , , , , , , , , , , , , , , , , , , , , , , , , , , , , , , , , , , ,#, , , , , ,#, , , , , , , ,#, , , , ,#
#, , , , , , , , , , , , ,#, , , , ,#, , , , , , , , , , , , , , , , , , , , , , , , , , , , , , , , , , , , , , , ,#, , , , , ,#, , , , , , , ,#, , , , ,#
#, , , , , , , , , , , , ,#, , , , ,#, , , , , , , , , , , , , , , , , , , , , , , , , , , , , , , , , , , , , , , ,#, , , , , ,#, , , , , , , ,#, , , , ,#
#, , , , , , , , , , , , ,#,#,#,#, ,#,#,#,#,#,#,#,#,#,#,#,#,#,#,#,#,#,#,#,#,#,#,#,#,#,#,#,#,#,#,#,#,#,#,#,#,#,#,#,#,#, , , , , ,#, ,#,#,#,#,#,#,#,#, ,#,#,#
#, , , , , , , , , , , , ,#, , , , , , , , ,#, , , ,#, , , , ,#, , , , , , , , , , , , , ,#, , , , ,#, , , ,#, , , ,#, , , , , ,#, , , , , , , , , , , , ,#
#, , , , , , , , , , , , ,#, , , , , , , , ,#, , , ,#, , , , ,#, , , , , , , , , , , , , ,#, , , , ,#, , , ,#, , , ,#, , , , , ,#, , , , , , , , , , , , ,#
#, , , , , , , , , , , , ,#, , , , , , , , ,#, , , ,#, , , , ,#, , , ,#,#,#,#,#,#,#, , , ,#, , , , ,#, , , ,#, , , ,#, , , , , , , , , , , , , , , , , , ,#
#,#,#,#,#,#,#,#,#,#, , ,#,#, , , , , , , , ,#, , , ,#, , , , ,#, , , ,#, , , , , ,#, , , ,#, , , , ,#, , , ,#, , , ,#, , , , , ,#, , , , , , , , , , , , ,#
#, , , , , , , , ,#, , , ,#, , , , , , , , ,#, , , ,#, , , , ,#, , , ,#, , , , , ,#, , , ,#, , , , ,#, , , ,#, , , ,#, , , , , ,#, ,#,#,#,#,#,#,#,#,#,#,#,#
#, , , , , , , , ,#, , , ,#, , , , , , , , ,#, , , ,#, ,#,#,#,#, , , ,#, , , , , ,#, , , ,#,#,#,#, ,#, , , ,#, , , ,#, , , , , ,#, , , , , , , , , , , , ,#
#, , , , , , , , ,#, , , ,#, , , , , , , , ,#,#,#, ,#, , , , ,#,#,#,#,#,#,#,#,#,#,#, , , ,#, , ,#, ,#,#, , ,#, , , ,#, , , , , ,#, , , , , , , , , , , , ,#
#, , , , , , , , ,#, , , ,#, , , , , , , , ,#, , , , , , , , ,#, , , , , , , , , , , , , ,#, , ,#, , , , , ,#, , , , , , , , , ,#, , , , , , , , , , , , ,#
#, , , , , , , , ,#, , , ,#,#,#, ,#,#,#,#,#,#,#,#,#,#,#, ,#,#,#, , , , , , , , , , , , , ,#,#, ,#,#,#,#, ,#,#,#,#,#,#,#, , , ,#,#, , , , , , , , , , , , ,#
#, , , , , , , , ,#, , , ,#, , , , , , , , , , , , , , , , , , , , , , , , , , , , , , , , , , , , , , , , , , , , , , , , , , , , , , , , , , , , , , , ,#
#, , , , , , , , , , , , , , , , , , , , , , , , , , , , , , , , , , , , , , , , , , , , , , , , , , , , , , , , , , , , , , , , , , , , , , , , , , , , ,#
#, , , , , , , , , , , , , , , , , , , , , , , , , , , , , , , , , , , , , , , , , , , , , , , , , , , , , , , , , , , , , , , ,#, , , , , , , , , , , , ,#
#, , , , , , , , ,#, , , ,#, , , , , , , , , , , , , , , , , , , , , , , , , , , , , , , , , , , , , , , , , , , , , , , , , , ,#, , , , , , , , , , , , ,#
#, , , , , , , , ,#, , , ,#,#,#,#, , ,#,#,#,#,#,#,#,#,#,#, , ,#,#, , ,#,#,#,#,#,#,#,#, ,#,#,#, ,#,#,#,#,#,#,#,#, , ,#,#,#,#,#,#,#, , , , , , , , , , , , ,#
#, , , , , , , , ,#, , , ,#, , , , , , , , , , , , , , , , , ,#, , , , , , , , , , ,#, , ,#, , , , , , , , , , , , , , , , , , ,#, , , , , , , , , , , , ,#
#, , , , , , , , ,#, , , ,#, , , , , , , , , , , , , , , , , ,#, , , , , , , , , , ,#, , ,#, , , ,#, , , , , , , , , , , , , , ,#, , , , , , , , , , , , ,#
#, , , , , , , , ,#, , , ,#, , , , , , , , , , , , , , , , , ,#, , , , , , , , , , ,#, , ,#, , , ,#, , , , , , , , , , , , , , ,#, , , , , , , , , , , , ,#
#, , , , , , , , ,#, , , ,#, , , , , , , , , , , , , , , , , ,#, , , , , , , , , , ,#, , ,#, , , ,#, , , , , , , , , , , , , , ,#, , , , , , , , , , , , ,#
#,#,#,#,#,#,#,#,#,#, , ,#,#, , , , , , , , , , , , , , , , , ,#, , , , , , , , , , ,#, , ,#, , , ,#, , , , , , , , , , , , , , ,#, , , , , , , , , , , , ,#
#, , , , , , , , , , , , ,#, , , , , , , , , , , , , , , , , ,#, , , , , , , , , , ,#, , ,#, ,#,#,#, , , , , , , , , , , , , , ,#, , , , , , , , , , , , ,#
#, , , , , , , , , , , , ,#, , , , , , , , , , , , , , , , , ,#, , , , , , , , , , ,#, , ,#, , , ,#, , , , , , , , , , , , , , ,#, , , , , , , , , , , , ,#
#, , , , , , , , , , , , ,#, , , , , , , , , , , , , , , , , ,#, , , , , , , , , , ,#, , ,#, , , ,#, , , , , , , , , , , , , , ,#, , , , , , , , , , , , ,#
#, , , , , , , , , , , , ,#, , , , , , , , , , , , , , , , , ,#, , , , , , , , , , ,#, , ,#, , , ,#, , , , , , , , , , , , , , ,#, , , , , , , , , , , , ,#
#, , , , , , , , , , , , ,#,#,#,#,#,#,#,#,#,#,#,#,#,#,#,#,#,#,#,#,#,#,#,#,#,#,#,#,#,#,#,#,#,#,#,#,#,#,#,#,#,#,#,#,#,#,#,#,#,#,#,#, , , , , , , , , , , , ,#
#, , , , , , , , , , , , ,#, , , , , , , , , , , , , , , , , , , , , , , , , , , , , , , , , , , , , , , , , , , , , , , , , , ,#, , , , , , , , , , , , ,#
#, , , , , , , , , , , , ,#, , , , , , , , , , , , , , , , , , , , , , , , , , , , , , , , , , , , , , , , , , , , , , , , , , ,#, , , , , , , , , , , , ,#
#, , , , , , , , , , , , ,#, , , , , , , , , , , , , , , , , , , , , , , , , , , , , , , , , , , , , , , , , , , , , , , , , , ,#, , , , , , , , , , , , ,#
#, , , , , , , , , , , , ,#, , , , , , , , , , , , , , , , , , , , , , , , , , , , , , , , , , , , , , , , , , , , , , , , , , ,#, , , , , , , , , , , , ,#
#, , , , , , , , , , , , ,#, , , , , , , , , , , , , , , , , , , , , , , , , , , , , , , , , , , , , , , , , , , , , , , , , , ,#, , , , , , , , , , , , ,#
#,#,#,#,#,#,#,#,#,#,#,#,#,#, , , , , , , , , , , , , , , , , , , , , , , , , , , , , , , , , , , , , , , , , , , , , , , , , , ,#,#,#,#,#,#,#,#,#,#,#,#,#,#
