 , , , , , , , , , , , , , , , , , , , , , , , , , , , , , , , , , , , , , , , , , , , , , , , , , , , , , , , , , , , , ,#,#,#,#, , , , , , , , , , , , , 
 , , , , , , , , , , , , , , , , , , , , , , , , , , , , , , , , , , , , , , , , , , , , , , , , , , , , , , , , , , , , ,#, , ,#, , , , , , , , , , , , , 
 , , , , , , , , , , , , , , , , , , , , , , , , , , , , , , , , , , , , , , , , , , , , , , , , , , , , , , , , , , , , ,#, , ,#, , , , , , , , , , , , , 
 , , , , , , , , , , , , , , ,#,#, , ,#,#,#,#,#,#,#,#,#,#,#,#,#,#,#,#,#,#,#,#,#,#,#,#,#,#,#,#,#,#,#,#,#,#,#,#, , ,#,#,#,#,#, , ,#, , , , , , , , , , , , , 
 , , , , , , , , , , , , , , ,#, , , , ,#, , , , ,#, , , , , , , , ,#, , , , ,#, , , , , , , , ,#, , , , ,#, , , , ,#, , , , , ,#, , , , , , , , , , , , , 
 , , , , , , , , , , , , , , ,#, , , , ,#, , , , ,#, , , , , , , , ,#, , , , ,#, , , , , , , , ,#, , , , ,#, , , , ,#, , , , , ,#, , , , , , , , , , , , , 
 , , , , , , , , , , , , , , ,#, , , , ,#, , , , ,#, , , , , , , , ,#, , , , ,#, , , , , , , , ,#, , , , ,#, , , , ,#,#,#,#, , ,#, , , , , , , , , , , , , 
 , , , , , , , , , , , , , , ,#, , , , ,#, , , , ,#, , , , , , , , ,#, , , , ,#, , , , , , , , ,#, , , , ,#, , , , , , , ,#, , ,#, , , , , , , , , , , , , 
 , , , , , , , , , , , , , , ,#, , , , ,#, , , , ,#, , , , , , , , ,#, , , , ,#, , , , , , , , ,#, , , , ,#, , , , , , , ,#, , ,#, , , , , , , , , , , , , 
 , , , , , , , , , , , , , , ,#,#,#,#, ,#,#,#,#, ,#,#, , ,#,#,#,#,#,#,#, , ,#,#,#,#, ,#,#, ,#,#,#,#, ,#,#,#, , , , , , , , , , ,#, , , , , , , , , , , , , 
 , , , , , , , , , , , , , , ,#, , , , , , , , , , , , , , , , , , , , , , , , , , , , , , , , , , , , , , , , , , , , , ,#, , ,#, , , , , , , , , , , , , 
 , , , , , , , , , , , , , , ,#, , , , , , , , , , , , , , , , , , , , , , , , , , , , , , , , , , , , , , , , , , , , , ,#, , ,#, , , , , , , , , , , , , 
 , , , , , , , , , , , , , , ,#, , , , , , , , , , , , , , , , , , , , , , , , , , , , , , , , , , , , , , , , , , , , , ,#,#,#,#, , , , , , , , , , , , , 
 , , , , , , , , , , , , , , ,#,#, , ,#,#,#, , ,#,#,#,#,#,#,#, , ,#,#,#,#,#,#,#,#,#,#,#,#, , ,#,#,#,#,#,#,#, , , , , , , ,#, , ,#, , , , , , , , , , , , , 
 , , , , , , , , , , , , , , ,#, , , , ,#, , , , , , , , , , , , , ,#, , , , ,#, , , , , , , , , , , , , ,#, , , , , , , ,#, , ,#, , , , , , , , , , , , , 
 , , , , , , , , , , , , , , ,#, , , , ,#, , , , , , , , , , , , , ,#, , , , ,#, , , , , , , , , , , , , ,#, , , , , ,#,#,#, , ,#, , , , , , , , , , , , , 
 , , , , , , , , , , , , , , ,#, , , , ,#, , , , , , , , , , , , , ,#, , , , ,#, , , , , , , , , , , , , ,#, , , , , , , , , , ,#, , , , , , , , , , , , , 
 , , , , , , , , , , , , , , ,#, , , , ,#, , , , , , , , , , , , , ,#, , , , ,#, , , , , , , , , , , , , ,#, , , , , , , , , , ,#, , , , , , , , , , , , , 
 , , , , , , , , , , , , , , ,#, , , , ,#, , , , , , , , , , , , , ,#, , , , ,#, , , , , , , , , , , , , ,#, , , , ,#,#,#,#,#,#,#,#,#,#,#,#,#,#,#,#,#,#,#,#
 , , , , , , , , , , , , , , ,#, , , , ,#, , , , , , , , , , , , , ,#, , , , ,#, , , , , , , , , , , , , ,#, , , , , , , , , , , , , , , , , , , , , , , ,#
 , , , , , , , , , , , , , , ,#, , , , ,#, , , , , , , , , , , , , ,#, , , , ,#, , , , , , , , , , , , , ,#, , , , ,#, , , , , , , , , , , , , , , , , , ,#
 , , , , , , , , , , , , , , ,#, , , , ,#, , , , , , , , , , , , , ,#, , , , ,#, , , , , , , , , , , , , ,#, , , , ,#, , , , , , , , , , , , , , , , , , ,#
 , , , , , , , , , , , , , , ,#,#,#,#,#,#,#,#,#,#,#,#,#,#,#,#,#,#,#,#,#,#,#,#,#,#,#,#,#,#,#,#,#,#,#,#,#,#,#, , , , ,#, , , , , , , , , , , , , , , , , , ,#
 , , , , , , , , , , , , , , , , , , , , , , , , , , , , , , , , , , , , , , , , , , , , , , , , , , , , , , , , , ,#, , , , , , , , , , , , , , , , , , ,#
 , , , , , , , , , , , , , , , , , , , , , , , , , , , , , , , , , , , , , , , , , , , , , , , , , , , , , , , , , ,#, , , , , , , , , , , , , , , , , , ,#
 , , , , , , , , , , , , , , , , , , , , , , , , , , , , , , , , , , , , , , , , , , , , , , , , , , , , , , , , , ,#, , , , , , , , , , , , , , , , , , ,#
 , , , , , , , , , , , , , , , , , , , , , , , , , , , , , , , , , , , , , , , , , , , , , , , , , , , , , , , , , ,#, , , , , , , , , , , , , , , , , , ,#
 , , , , , , , , , , , , , , , , , , , , , , , , , , , , , , , , , , , , , , , , , , , , , , , , , , , , , , , , , ,#, , , , , , , , , , , , , , , , , , ,#
 , , , , , , , , , , , , , , , , , , , , , , , , , , , , , , , , , , , , , , , , , , , , , , , , , , , , , , , , , ,#, , , , , , , , , , , , , , , , , , ,#
 , , , , , , , , , , , , , , , , , , , , , , , , , , , , , , , , , , , , , , , , , , , , , , , , , , , , , , , , , ,#, , , , , , , , , , , , , , , , , , ,#
 , , , , , , , , , , , , , , , , , , , , , , , , , , , , , , , , , , , , , , , , , , , , , , , , , , , , , , , , , ,#, , , , , , , , , , , , , , , , , , ,#
 , , , , , , , , , , , , , , , , , , , , , , , , , , , , , , , , , , , , , , , , , , , , , , , , , , , , , , , , , ,#, , , , , , , , , , , , , , , , , , ,#
 , , , , , , , , , , , , , , , , , , , , , , , , , , , , , , , , , , , , , , , , , , , , , , , , , , , , , , , , , ,#, , , , , , , , , , , , , , , , , , ,#
 , , , , , , , , , , , , , , , , , , , , , , , , , , , , , , , , , , , , , , , , , , , , , , , , , , , , , , , , , ,#, , , , , , , , , , , , , , , , , , ,#
 , , , , , , , , , , , , , , , , , , , , , , , , , , , , , , , , , , , , , , , , , , , , , , , , , , , , , , , , , ,#, , , , , , , , , , , , , , , , , , ,#
 , , , , , , , , , , , , , , , , , , , , , , , , , , , , , , , , , , , , , , , , , , , , , , , , , , , , , , , , , ,#, , , , , , , , , , , , , , , , , , , 
 , , , , , , , , , , , , , , , , , , , , , , , , , , , , , , , , , , , , , , , , , , , , , , , , , , , , , , , , , , , , , , , , , , , , , , , , , , , , , 
 , , , , , , , , , , , , , , , , , , , , , , , , , , , , , , , , , , , , , , , , , , , , , , , , , , , , , , , , , , , , , , , , , , , , , , , , , , , , , 
 , , , , , , , , , , , , , , , , , , , , , , , , , , , , , , , , , , , , , , , , , , , , , , , , , , , , , , , , , , , , , , , , , , , , , , , , , , , , ,#
 , , , , , , , , , , , , , , , , , , , , , , , , , , , , , , , , , , , , , , , , , , , , , , , , , , , , , , , , , ,#, , , , , , , , , , , , , , , , , , ,#
 , , , , , , , , , , , , , , , , , , , , , , , , , , , , , , , , , , , , , , , , , , , , , , , , , , , , , , , , , ,#, , , , , , , , , , , , , , , , , , ,#
 , , , , , , , , , , , , , , , , , , , , , , , , , , , , , , , , , , , , , , , , , , , , , , , , , , , , , , , , , ,#, , , , , , , , , , , , , , , , , , ,#
 , , , , , , , , , , , , , , , , , , , , , , , , , , , , , , , , , , , , , , , , , , , , , , , , , , , , , , , , , ,#, , , , , , , , , , , , , , , , , , ,#
 , , , , , , , , , , , , , , , , , , , , , , , , , , , , , , , , , , , , , , , , , , , , , , , , , , , , , , , , , ,#, , , , , , , , , , , , , , , , , , ,#
 , , , , , , , , , , , , , , , , , , , , , , , , , , , , , , , , , , , , , , , , , , , , , , , , , , , , , , , , , ,#, , , , , , , , , , , , , , , , , , ,#
 , , , , , , , , , , , , , , , , , , , , , , , , , , , , , , , , , , , , , , , , , , , , , , , , , , , , , , , , , ,#, , , , , , , , , , , , , , , , , , ,#
 , , , , , , , , , , , , , , , , , , , , , , , , , , , , , , , , , , , , , , , , , , , , , , , , , , , , , , , , , ,#, , , , , , , , , , , , , , , , , , ,#
 , , , , , , , , , , , , , , , , , , , , , , , , , , , , , , , , , , , , , , , , , , , , , , , , , , , , , , , , , ,#, , , , , , , , , , , , , , , , , , ,#
 , , , , , , , , , , , , , , , , , , , , , , , , , , , , , , , , , , , , , , , , , , , , , , , , , , , , , , , , , ,#, , , , , , , , , , , , , , , , , , ,#
 , , , , , , , , , , , , , , , , , , , , , , , , , , , , , , , , , , , , , , , , , , , , , , , , , , , , , , , , , ,#, , , , , , , , , , , , , , , , , , ,#
 , , , , , , , , , , , , , , , , , , , , , , , , , , , , , , , , , , , , , , , , , , , , , , , , , , , , , , , , , ,#, , , , , , , , , , , , , , , , , , ,#
 , , , , , , , , , , , , , , , , , , , , , , , , , , , , , , , , , , , , , , , , , , , , , , , , , , , , , , , , , ,#, , , , , , , , , , , , , , , , , , ,#
 , , , , , , , , , , , , , , , , , , , , , , , , , , , , , , , , , , , , , , , , , , , , , , , , , , , , , , , , , ,#, , , , , , , , , , , , , , , , , , ,#
 , , , , , , , , , , , , , , , , , , , , , , , , , , , , , , , , , , , , , , , , , , , , , , , , , , , , , , , , , ,#, , , , , , , , , , , , , , , , , , ,#
 , , , , , , , , , , , , , , , , , , , , , , , , , , , , , , , , , , , , , , , , , , , , , , , , , , , , , , , , , ,#, , , , , , , , , , , , , , , , , , , 
 , , , , , , , , , , , , , , , , , , , , , , , , , , , , , , , , , , , , , , , , , , , , , , , , , , , , , , , , , ,#, , , , , , , , , , , , , , , , , , , 
 , , , , , , , , , , , , , , , , , , , , , , , , , , , , , , , , , , , , , , , , , , , , , , , , , , , , , , , , , ,#, , , , , , , , , , , , , , , , , , , 
#,#,#,#,#,#,#,#,#,#,#,#,#,#,#,#,#,#,#, , , , , , , , , , , , , , , , , , , , , , , , , , , , , , , , , , , ,#,#,#,#,#,#,#,#,#,#,#,#,#,#,#,#,#,#,#,#,#,#,#,#
#, , , , , , , ,#, , , , ,#, , , , ,#, , , , , , , , , , , , , , , , , , , , , , , , , , , , , , , , , , , ,#, , , ,#, , , , , ,#, , , , , , ,#, , , , , ,#
#, , , , , , , ,#, , , , ,#, , , , ,#, , , , , , , , , , , , , , , , , , , , , , , , , , , , , , , , , , , ,#, , , ,#, , , , , ,#, , , , , , ,#, , , , , ,#
#, , , , , , , ,#, , , , ,#,#,#,#,#,#, , , , , , , , , , , , , , , , , , , , , , , , , , , , , , , , , , , ,#, , , ,#, , , , , ,#, , , , , , ,#, , , , , ,#
#, , , , , , , ,#, , , , ,#, , , , ,#, , , , , , , , , , , , , , , , , , , , , , , , , , , , , , , , , , , ,#, , , ,#, , , , , ,#,#,#,#,#, ,#,#, , , , , ,#
#, , , , , , , ,#, , , , ,#, , , , ,#, , , , , , , , , , , , , , , , , , , , , , , , , , , , , , , , , , , ,#, , , ,#, , , , , ,#, , , , , , ,#, , , , , ,#
#,#,#,#,#,#,#, ,#, , , , ,#,#,#,#, ,#,#,#,#,#,#,#,#,#,#,#,#,#,#,#,#,#,#,#, , , ,#,#,#,#,#,#,#,#,#,#,#,#,#,#,#,#, ,#,#,#,#,#,#,#,#, , , , , , ,#, , , , , ,#
#, , , , , ,#, , , , ,#,#,#, , , , , , , , , ,#, , , ,#, , , ,#, , , ,#, , , , , , ,#, , ,#, , , , ,#, , , ,#, , , , ,#, , , , ,#, , , , , , ,#, , , , , ,#
#, , , , , ,#, , , , ,#, ,#, , , , , , , , , ,#, , , ,#, , , ,#, , , ,#, , , , , , ,#, , ,#, , , , ,#, , , ,#, , , , ,#, , , , ,#, , , , , , ,#, , , , , ,#
#, , , , , , , , , , ,#, ,#, , , , , , , , , ,#, , , ,#, , , ,#, , ,#,#,#,#,#,#,#,#,#, , ,#, , , , ,#, , , ,#, , , , ,#, , , , ,#, , , , , , ,#, , , , , ,#
#,#,#,#,#,#,#, , , , , , ,#, , , , , , , , , ,#, , , ,#, , , ,#, , ,#, , , , , , , ,#, , ,#, , , , ,#, , , ,#, , , , ,#, , , , ,#,#,#,#,#, ,#,#, , , , , ,#
#, , , , , , , , , , , , ,#, , , , , , , , , ,#, , , ,#, , , ,#, , ,#, , , , , , , ,#, , ,#, , , , , , , , ,#, , , , ,#, , , , ,#, ,#, , , , ,#, , , , , ,#
#, , , , , , , , , , , , ,#, , , , , , , , , ,#,#,#, ,#, , , ,#, , ,#, , , , , , , ,#, , ,#,#,#,#,#,#, , , ,#, , , , ,#, , , , ,#, ,#,#, , , , , , , , , ,#
#, , , , , ,#, , , , , , ,#, , , , , , , , , ,#, , , ,#, , , ,#, , ,#, ,#, , , ,#, ,#,#, ,#, , , , ,#, , , ,#, , , , ,#, , , , ,#, , , , , , , , , , , , ,#
#,#,#,#,#,#,#, , ,#,#,#,#,#, , , , , , , , , ,#, , , , , , , ,#, , , , , , , , , , , , , ,#, , , , , , , , ,#, , , , ,#, , , , ,#,#,#,#, , ,#,#,#,#,#,#,#,#
#, , , , , , , , , , , , ,#,#,#,#,#,#, ,#,#,#,#, ,#,#,#,#,#,#,#, , , , , , , , , , , , , ,#,#,#,#,#,#,#, ,#,#,#, ,#,#,#,#, ,#,#,#, , , , , , , , , , , , ,#
 , , , , , , , , , , , , , , , , , , , , , , , , , , , , , , , , , , , , , , , , , , , , , , , , , , , , , , , , , , , , , , , , , , , , , , , , , , , , , 
 , , , , , , , , , , , , , , , , , , , , , , , , , , , , , , , , , , , , , , , , , , , , , , , , , , , , , , , , , , , , , , , , , , , , , , , , , , , , , 
 , , , , , , , , , , , , , , , , , , , , , , , , , , , , , , , , , , , , , , , , , , , , , , , , , , , , , , , , , , , , , , , , , , , , , , , , , , , , , 
#, , , , , , , , , , , , , , , , , , , , , , , , , , , , , , , , , , , , , , , , , , , , , , , , , , , , , , , , , , , , , , , , , , , , , , , , , , , , ,#
#,#,#,#,#,#,#,#, ,#,#,#,#,#,#,#, ,#,#,#, ,#,#,#,#,#,#,#,#, ,#,#, , , , ,#, , , ,#, , , , ,#,#,#,#,#,#,#,#, ,#,#,#,#,#,#,#,#, ,#,#,#,#,#, , ,#,#,#,#,#,#,#,#
#, , , , , , , , , , , , , , , , , ,#, , , , ,#, , , , , , , ,#, , , , , , , , , , , , , ,#, , , , , , , , , , , , , ,#, , , , ,#, , , , , , ,#, , , , , ,#
#, , , , , , , , , , , , ,#, , , , ,#, , , , ,#, , , , , , , ,#, , , , , , , , , , , , , ,#, , , , , , , , , , , , , , , , , , ,#, , , , , , , , , , , , ,#
#, , , , , , , , , , , , ,#, ,#, , ,#, , , , ,#, , , , , , , ,#, , , , , , , , , , , , , ,#, , , , , , , , , , , , , ,#, , , , ,#, , ,#,#,#,#,#, , , , , ,#
#, , , , , , , , , , , , ,#, ,#, , , , , , , ,#, , , , , , , ,#, , , , , , , , , , , , , ,#, , , , , , , , , , , , , ,#, , , , ,#, , ,#, , , , , , , , , ,#
#,#,#,#, ,#,#,#,#,#,#,#,#,#, ,#, , , , , , , ,#, , , , , , , ,#, , , , , , , , , , , , , ,#, , , , , , , , , , , , , ,#,#,#,#,#,#, , ,#, , , , , , , , , ,#
#, , , , , , , , ,#, , , ,#, ,#, , , , , , , ,#, , , , , , , ,#, , , , , , , , , , , , , ,#, , , , , , , , , , , , , , , , , , ,#, , ,#, , , , , , , , , ,#
#, , , , , , , , ,#, , , ,#,#,#, , , , , , , ,#, , , , , , , ,#, , , , , , , , , , , , , ,#, , , , , , , , , , , , , , , , , , ,#,#,#,#, , , , , , , , , ,#
#, , , , , , , , ,#,#,#,#,#, , , , , , , , , ,#, , , , , , , ,#, , , , , , , , , , , , , ,#, , , , , , , , , , , , , , , , , , ,#, , ,#, , , , , , , , , ,#
#, , , , , , , , ,#, , , ,#, , , , , , , , , ,#, , , , , , , ,#, , , , , , , , , , , , , ,#, , , , , , , , , , , , , , , , , , ,#, , , , , , , , , , , , ,#
#, , , , , , , , ,#,#,#,#,#,#,#,#,#,#,#,#,#,#,#,#,#,#,#,#,#,#,#,#, , ,#,#, , , ,#,#, , ,#,#,#,#,#,#,#,#,#,#,#,#,#,#,#,#,#,#,#,#,#, ,#,#, , , , , , , , , ,#
#, , , , , , , , ,#, , , ,#, , , , , , , , , , , , , , , , , , , , , , , , , , , , , , , , , , , , , , , , , , , , , , , , , , ,#, , , , , , , , , , , , ,#
#, , , , , , , , ,#, , , ,#, , , , , , , , , , , , , , , , , , , , , , , , , , , , , , , , , , , , , , , , , , , , , , , , , , ,#, , ,#, , , , , , , , , ,#
#, , , , , , , , ,#, ,#,#,#, , , , , , , , , , , , , , , , , , , , , , , , , , , , , , , , , , , , , , , , , , , , , , , , , , ,#, , ,#, , , , , , , , , ,#
#, , , , , , , , ,#, , , ,#, , , , , , , , , , , , , , , , , , , , , , , , , , , , , , , , , , , , , , , , , , , , , , , , , , ,#, , ,#, , , , , , , , , ,#
#, , , , , , , , , , , , ,#, , , , , , , , , , , , , , , , , , , , , , , , , , , , , , , , , , , , , , , , , , , , , , , , , , ,#, , ,#, , , , , , , , , ,#
#,#,#,#,#,#,#,#,#,#,#,#,#,#, , , , , , , , , , , , , , , , , , , , , , , , , , , , , , , , , , , , , , , , , , , , , , , , , , ,#,#,#,#,#,#,#,#,#,#,#,#,#,#
